00000000
11000000
01111110
11010000
01000111
01111100
00000000