000000000
111111100
010101000
010101100
011000100
010001100
000001000
000001000